NO ./path_north
SO ./path_south_failed
WE ./path_west

EA ./path_east
F a0,100,100
C 0,255,255

111111111111111
100000000000001
11111111100000111111111
	111000000000001
	100000000000001
	110000000000001
	11111W000000001
	111111111111111
