NO	./texture/north.xpm

SO	./texture/south.xpm
WE	./texture/west.xpm
EA	./texture/east.xpm

F	0,254,126
C	123,0,91

111111111111
111111111001
        1001
        11001
        111001
        10011
        10011111111111111
        1110000000000000N11
          11111000000000011
          11111111111011111
          11000000000000001
          10000000000000001
          11111111111111111
