NO	./texture/north.xpm
SO	./texture/south.xpm
EA	./texture/east.xpm

F	100,200,0
C	0, 100, 200

1111111111
10000000N1
1000000001
1111111111
