NO	./texture/north.xpm

SO	./texture/south.xpm
WE	./texture/west.xpm
EA	./texture/east.xpm

F	0,254,126
C	123,0,91

111111111111
100000000001
111110011111
110N00000011
111001111111
100000000001
110000000001
111111111111
111    11111
